0,0,0,0,0,0,0,0,0,0,0,0,0,0,0
0,0,0,0,0,0,0,0,0,0,0,0,0,0,0
0,0,0,0,0,0,0,0,0,0,0,0,0,0,0
0,0,0,0,0,0,0,0,0,0,0,0,0,0,0
0,0,0,0,0,0,0,9,0,0,0,0,0,0,0
0,0,0,0,0,0,2,30,1,0,0,3,0,4,0
0,0,0,0,0,1,30,30,30,2,0,30,0,30,30
0,0,0,0,0,30,30,30,31,30,0,30,30,30,30
0,0,0,3,0,0,0,0,0,0,0,4,0,0,0
10,11,12,10,10,14,10,13,11,10,12,10,10,10,11