0,0,0,0,0,0,0,0,0,0,0,0,0,0,0
0,0,0,0,0,0,0,0,0,0,0,0,0,0,0
0,0,0,0,0,0,0,0,0,0,0,0,0,0,0
0,0,0,0,0,0,0,0,0,0,0,0,0,0,0
0,0,0,0,0,0,0,0,0,0,0,0,0,0,0
0,0,0,0,0,0,0,0,0,0,0,0,0,0,0
1,2,3,4,0,0,0,0,0,0,0,1,2,3,4
11,12,13,10,14,10,0,9,0,10,11,10,12,13,10
22,20,20,20,23,23,0,44,0,22,20,20,20,20,21
21,20,20,20,20,22,42,21,41,20,20,20,20,23,20