10,10,11,12,13,10,14,5,11,12,10,13,10,10,10
21,20,20,22,20,20,21,1,21,20,20,20,22,20,23
20,20,20,20,20,21,22,5,20,21,22,20,20,20,21
20,23,20,20,20,20,20,4,20,20,22,20,23,20,20
20,20,20,22,20,21,23,2,20,20,20,20,20,20,20
21,22,20,20,20,20,20,1,22,20,20,22,20,20,22
20,20,20,21,20,23,20,3,21,21,20,20,22,20,20
20,20,21,20,22,20,20,2,20,21,22,20,20,20,21
0,0,0,2,5,4,0,1,0,3,1,5,2,0,0
10,11,12,10,14,10,13,10,11,12,10,13,14,10,10