0,0,0,0,0,0,0,0,0,0,0,0,0,0,0
0,0,0,0,0,0,0,0,0,0,0,0,0,0,0
0,1,0,0,0,0,0,0,0,0,0,0,0,0,0
10,14,4,0,0,0,0,0,0,0,0,0,0,0,0
22,20,44,4,0,3,0,0,0,0,0,0,0,0,0
20,21,22,43,0,2,0,0,0,0,0,0,1,5,0
0,0,0,0,0,3,13,10,11,10,0,12,10,13,11
0,0,0,0,2,43,20,20,20,22,42,22,21,20,20
0,0,0,5,40,21,20,20,22,20,23,20,20,20,20
44,40,40,41,22,20,20,21,20,20,20,20,23,22,21