0,0,0,0,0,0,0,0,0,0,0,0,0,0,0
10,11,12,10,0,0,0,9,0,12,10,14,10,11,10
20,20,21,20,2,1,0,1,3,20,21,22,20,20,21
20,20,20,22,1,3,9,2,1,22,20,20,23,20,20
21,20,20,23,5,2,3,4,5,20,21,22,20,20,21
20,22,20,1,2,9,4,1,3,23,20,20,20,23,20
20,20,22,42,5,1,3,2,4,2,20,21,20,20,20
20,21,21,20,9,3,4,5,1,43,20,22,20,20,23
22,20,21,20,40,41,42,43,44,20,20,20,21,20,20
20,20,20,20,22,20,21,20,20,23,20,20,20,21,22