0,0,0,0,0,0,0,0,0,0,0,0,0,0,0
0,0,0,0,2,0,0,0,0,0,0,2,0,0,0
0,0,0,0,1,0,0,0,0,0,0,1,0,0,0
0,0,0,0,2,0,0,0,9,0,0,2,0,0,0
0,0,0,0,30,0,9,0,30,9,0,30,0,0,0
0,0,0,0,31,0,30,0,31,30,0,30,0,0,0
0,0,0,0,30,30,30,30,30,30,30,30,0,0,0
0,0,0,0,0,0,0,0,0,0,0,0,0,0,0
0,0,0,0,0,0,0,0,0,0,0,0,0,0,0
10,12,13,14,10,14,10,12,11,10,11,12,10,14,10