0,0,0,0,0,0,0,0,0,0,0,0,0,0,0
0,0,0,0,0,0,0,0,0,0,0,0,0,0,0
0,0,0,0,0,0,0,0,0,0,0,0,0,0,0
0,0,0,0,0,0,0,0,0,0,0,0,0,0,0
4,0,0,0,0,0,0,0,0,0,0,0,0,0,5
10,1,0,0,0,0,0,0,0,0,0,0,0,2,11
23,41,2,0,0,0,0,0,0,0,0,0,1,40,22
20,22,42,3,0,30,30,30,30,30,0,3,42,20,21
21,20,20,43,5,0,0,0,0,0,4,41,22,23,20
20,21,20,20,40,41,40,43,44,40,41,20,20,22,21