10,11,10,12,13,10,1,9,14,10,11,12,10,10,10
22,20,21,21,20,20,13,3,2,23,20,20,21,21,20
20,20,20,22,20,22,4,2,42,22,20,21,20,20,20
23,20,20,20,21,23,41,3,1,20,20,20,20,21,23
20,22,20,20,21,20,0,5,40,20,20,20,22,20,20
20,20,23,20,20,22,42,9,4,23,20,20,21,20,20
20,20,20,22,20,20,2,5,44,20,20,23,20,20,22
21,20,21,20,20,21,41,2,1,22,21,20,20,20,20
20,20,20,20,22,22,0,1,9,0,20,20,20,20,21
20,21,20,23,20,20,43,40,40,41,20,20,22,20,20