0,0,0,0,0,0,0,0,0,0,0,0,0,0,0
0,0,0,0,0,0,0,0,0,0,0,0,0,0,0
0,0,0,0,0,0,0,0,0,0,0,0,0,0,0
0,0,0,2,3,0,0,0,0,0,2,3,2,0,0
1,0,2,4,5,0,0,0,0,0,4,5,9,1,0
11,0,14,10,11,12,0,0,0,10,11,12,13,14,10
20,23,20,22,21,20,0,0,0,21,20,22,20,23,20
20,21,20,20,20,21,0,0,0,20,21,20,22,20,20
21,22,20,20,23,22,0,44,0,0,23,20,20,20,21
20,20,21,20,20,22,41,22,42,43,21,20,20,20,20