10,12,10,11,2,14,10,13,10,10,5,11,10,10,10
20,21,21,20,9,22,23,20,20,20,9,22,21,23,20
22,20,20,21,5,21,22,22,20,21,1,20,20,20,21
22,20,20,22,1,20,20,20,21,22,4,20,22,20,20
20,20,21,23,4,20,23,20,20,20,3,22,20,22,20
20,23,20,21,3,22,20,22,21,20,2,20,20,20,21
22,20,20,20,4,21,20,20,20,23,4,21,20,22,20
21,20,20,23,3,20,20,21,22,23,1,20,20,21,20
0,0,0,2,5,0,1,3,2,0,5,0,0,0,0
11,12,10,13,14,10,11,11,10,12,13,14,10,10,11