0,0,0,0,0,0,0,0,0,0,0,0,0,0,0
1,0,0,0,0,0,0,0,0,0,0,0,0,0,0
10,2,0,0,0,0,0,0,0,0,0,0,0,0,0
20,44,3,0,0,0,0,0,0,0,0,0,0,0,0
21,22,40,4,0,0,0,0,0,0,0,0,0,0,3
23,20,20,41,4,0,0,0,0,0,0,0,0,0,2
20,20,20,22,42,2,0,0,0,0,0,5,0,0,1
20,21,22,20,20,44,2,9,1,0,0,31,9,0,30
21,21,20,22,20,23,43,1,30,5,30,30,30,0,30
20,21,22,20,20,21,21,41,44,41,40,42,42,40,40