0,0,0,0,0,0,0,0,0,0,0,0,0,0,0
0,2,4,9,1,5,3,0,2,4,1,5,9,1,3
10,11,12,10,10,14,10,0,12,11,10,10,13,10,10
20,20,20,20,21,20,20,0,20,22,20,23,20,20,20
22,20,22,20,22,21,21,0,0,0,20,20,20,22,20
21,20,22,23,20,20,20,0,21,0,22,20,20,20,23
20,21,20,20,20,22,23,0,22,0,20,21,20,20,22
22,20,20,23,22,20,20,0,23,0,20,20,22,23,20
20,20,21,20,22,21,1,0,0,0,21,20,21,20,20
20,20,21,20,22,23,21,20,20,20,21,20,22,20,20