0,0,0,0,0,0,0,0,0,0,0,0,0,0,0
0,0,0,3,0,3,0,3,0,3,0,1,0,0,0
0,0,0,30,0,30,0,31,0,30,0,30,0,0,0
0,0,0,0,2,0,2,0,2,0,2,0,0,0,0
0,0,0,0,30,0,30,0,30,0,31,0,0,0,0
0,0,0,1,0,0,0,0,0,0,0,0,0,0,0
0,0,0,30,0,31,0,30,0,30,0,30,0,0,0
0,0,0,0,0,0,0,0,0,0,0,0,0,0,0
0,0,0,0,30,0,31,0,30,0,30,0,0,0,0
10,10,11,11,10,12,13,10,14,10,10,11,10,12,14