0,0,0,0,0,0,0,0,0,0,0,0,0,0,0
0,0,0,0,0,0,0,1,0,0,0,0,0,0,0
0,0,0,0,0,0,0,3,0,0,0,0,0,0,0
0,0,0,0,0,0,0,5,0,0,0,0,0,0,0
0,0,0,1,0,0,0,3,0,0,0,4,0,0,0
0,0,0,5,0,0,0,2,0,0,0,2,0,0,0
0,0,0,4,0,0,0,3,0,0,0,3,0,0,0
0,0,0,30,0,0,0,30,0,0,0,31,0,0,0
0,0,30,30,30,0,30,30,30,0,30,30,30,0,0
10,11,12,12,10,13,14,10,10,11,10,11,12,10,10