21,21,20,20,22,23,20,20,20,21,21,20,20,20,20
20,20,20,21,22,20,20,21,23,20,20,20,23,22,22
23,22,21,20,0,2,1,3,4,5,0,20,20,21,20
20,21,22,20,0,10,11,12,13,11,0,22,22,20,21
20,20,20,20,0,5,1,3,2,4,0,20,20,22,23
20,23,22,20,0,11,12,10,10,11,0,21,20,20,20
20,21,20,22,0,3,5,1,2,3,0,20,21,23,20
22,23,20,20,0,13,10,10,11,13,0,22,20,20,20
20,20,20,21,0,5,1,9,2,0,0,22,21,20,23
20,21,22,20,40,40,42,41,42,44,43,20,22,23,20