0,0,0,0,0,0,0,0,0,0,0,0,0,0,0
0,0,0,0,0,0,0,0,0,0,0,0,0,0,0
0,0,0,0,0,0,0,0,0,0,0,0,0,0,0
0,0,0,0,0,0,0,0,0,0,0,0,0,0,0
0,0,0,0,0,0,0,0,0,0,0,0,0,0,0
5,2,3,4,5,0,5,0,1,0,5,4,3,2,1
10,10,12,11,10,0,13,0,14,0,10,11,11,10,10
20,20,22,20,20,21,20,20,23,20,21,20,20,20,20
21,22,23,21,21,20,20,20,21,20,20,21,22,20,21
20,20,23,23,20,21,22,23,22,20,20,21,20,20,20