0,0,0,0,0,0,0,0,0,0,0,0,0,0,0
0,0,0,0,0,0,0,0,0,0,0,0,0,0,0
0,4,1,2,3,9,5,0,1,2,3,4,5,1,0
30,30,30,30,31,30,30,0,30,30,30,30,30,30,30
0,1,2,3,2,3,9,0,1,2,9,4,5,3,0
30,31,30,30,30,30,30,0,30,30,30,30,30,31,30
0,1,3,2,9,2,1,0,9,4,5,4,5,3,0
30,30,30,30,30,30,30,0,30,30,30,30,30,30,30
0,2,5,3,2,3,5,0,9,5,4,3,2,1,0
10,12,10,11,13,10,14,11,10,10,10,12,13,10,11