22,20,23,21,20,20,0,4,0,22,20,22,20,20,20
20,21,20,22,20,22,0,2,0,20,23,21,20,22,20
21,21,20,20,20,20,9,30,9,22,23,20,20,21,20
20,20,21,22,20,21,1,0,1,20,21,20,20,20,20
20,20,20,21,22,23,30,9,30,20,22,23,20,20,21
21,22,23,20,20,21,0,5,0,21,22,22,21,20,20
22,20,23,21,20,20,0,30,9,22,20,22,20,20,20
20,20,21,22,20,21,0,0,5,20,21,20,20,20,20
21,20,21,20,22,20,30,4,30,21,22,20,20,23,20
20,20,20,21,22,23,40,2,41,20,22,23,20,20,21