22,20,20,20,20,22,21,1,22,20,20,20,21,23,22
20,23,22,20,22,20,1,3,21,20,22,22,20,21,20
20,21,20,20,20,22,2,42,21,22,20,20,22,20,20
21,20,23,22,21,22,5,4,1,23,20,20,20,22,21
20,20,20,20,20,22,44,40,3,20,22,22,20,21,20
20,22,23,20,21,20,22,0,4,0,22,20,21,20,22
21,20,20,23,22,20,21,41,5,40,22,21,20,20,20
23,22,20,21,20,0,0,1,2,20,22,20,20,22,21
20,21,20,22,23,42,40,40,41,20,21,20,22,20,20
20,20,21,20,22,21,20,23,21,20,20,21,22,20,20