0,0,0,0,0,0,0,0,0,0,0,0,0,0,0
0,0,0,1,0,0,0,0,0,0,0,4,0,0,0
0,0,0,2,0,0,0,0,0,0,0,2,0,0,0
0,0,0,4,0,0,0,0,0,0,0,3,0,0,0
0,0,0,5,0,0,0,0,0,0,0,5,0,0,0
0,0,0,3,0,0,0,1,0,0,0,1,0,0,0
0,0,0,5,0,0,0,9,0,0,0,5,0,0,0
0,0,0,30,0,9,0,30,0,1,0,30,0,0,0
0,0,0,30,0,30,0,30,0,31,0,30,0,0,0
10,10,11,12,13,10,14,11,10,10,12,11,10,13,10