10,11,12,13,0,0,10,10,10,0,0,11,12,10,13
20,21,20,21,4,0,20,22,21,0,0,20,21,20,22
20,21,22,23,3,0,23,20,23,1,2,21,20,20,23
21,20,20,20,9,1,20,22,20,9,3,23,23,20,21
23,20,21,21,4,3,20,22,22,1,5,20,20,22,21
22,21,20,21,2,5,21,20,20,4,3,21,20,22,20
23,23,21,20,5,4,21,20,23,5,1,20,22,21,23
20,20,20,20,2,3,20,21,22,3,4,20,21,22,20
0,0,0,0,4,1,0,0,0,1,2,0,0,0,0
10,12,11,12,13,10,11,14,12,10,10,11,11,12,14