0,0,0,0,0,0,0,0,0,0,0,0,0,0,0
0,0,0,0,0,0,0,0,0,0,0,0,0,0,0
0,0,0,0,0,0,0,0,0,0,0,0,0,0,0
0,0,0,0,0,0,0,0,0,0,0,0,0,0,0
0,0,0,0,0,0,0,0,0,0,0,0,0,0,0
0,0,0,0,0,0,0,0,0,0,0,0,0,0,0
0,0,0,1,0,0,0,0,0,0,0,1,0,0,0
0,0,0,2,0,0,0,0,0,0,0,2,0,0,0
14,10,10,12,10,0,11,10,13,0,10,12,10,12,10
23,22,20,20,23,44,21,20,20,40,20,20,22,20,20