0,0,0,0,0,0,0,0,0,0,0,0,0,0,0
0,0,0,0,0,0,0,0,0,0,0,0,0,0,0
0,0,0,0,0,0,0,0,0,0,0,0,0,0,0
0,0,0,0,0,0,0,0,0,0,0,0,0,0,0
0,0,0,0,0,0,0,0,0,0,0,0,0,0,0
0,0,1,0,0,0,0,0,0,0,0,0,1,0,0
0,0,2,0,0,0,0,0,0,0,0,0,2,0,0
0,0,3,0,0,0,0,0,0,0,0,0,3,0,0
10,11,10,14,0,14,10,0,11,10,0,12,10,10,10
23,20,20,21,41,20,20,44,20,20,40,22,20,20,20