0,0,0,0,0,0,0,0,0,0,0,0,0,0,0
0,0,0,0,0,0,0,0,0,0,0,0,0,0,0
0,0,0,0,0,0,0,0,0,0,0,0,0,0,0
0,0,0,0,0,0,0,0,0,0,0,0,0,0,0
0,0,0,0,0,0,0,0,0,0,0,0,0,0,0
0,0,0,0,0,0,0,0,0,0,2,9,1,3,0
0,0,0,0,0,0,0,0,0,0,11,10,11,12,10
10,11,10,12,10,14,2,9,1,0,3,20,21,20,20
20,20,22,21,20,20,40,41,40,0,40,20,20,20,21
23,20,20,20,21,20,22,20,20,44,20,20,20,23,22