0,0,0,0,0,0,0,0,0,0,0,0,0,0,0
0,0,0,0,0,0,0,0,0,0,0,0,0,0,0
0,0,0,0,0,0,0,0,0,0,0,0,0,0,0
0,0,0,0,0,0,0,0,0,0,3,2,3,0,0
0,0,0,2,1,0,0,0,0,0,12,10,10,11,10
14,10,10,10,13,1,0,0,0,0,22,20,20,20,20
20,20,22,20,20,42,0,0,0,0,20,20,20,21,20
20,20,20,21,20,20,41,0,40,0,23,21,20,20,20
20,21,23,20,20,20,20,42,20,0,20,20,20,22,20
21,22,20,20,20,20,20,20,23,44,21,20,20,20,20