0,0,0,0,0,0,0,0,0,0,0,0,0,0,0
0,0,0,0,0,0,0,0,0,0,0,0,0,0,0
0,0,0,0,0,0,0,0,0,0,0,0,0,0,0
0,0,0,0,0,0,0,0,0,0,0,0,0,0,0
0,0,0,1,0,0,0,0,0,0,0,4,0,0,0
0,0,0,2,0,0,0,0,0,0,0,3,0,0,0
0,0,0,3,0,0,0,0,0,0,0,2,0,0,0
0,0,0,4,0,0,0,0,0,0,0,1,0,0,0
10,11,12,10,0,13,0,14,0,10,0,10,12,10,10
23,20,20,22,43,22,40,21,43,20,42,20,20,20,21