0,0,0,0,0,0,0,0,0,0,0,0,0,0,0
0,0,0,0,0,0,0,0,0,0,0,0,0,0,0
0,0,0,0,0,0,0,0,0,0,0,0,0,0,0
0,0,5,3,2,0,0,3,5,9,1,0,0,0,0
11,10,11,12,10,10,0,14,13,10,10,12,11,10,10
20,20,22,21,2,9,0,21,20,20,20,20,21,20,22
20,20,22,20,41,42,0,20,20,23,20,20,22,20,20
20,20,20,20,21,1,0,20,21,20,20,23,20,20,20
21,20,20,23,20,44,0,20,20,21,22,20,20,22,21
20,21,20,20,20,22,40,22,20,20,21,23,20,20,20